################
#           P  # 
#  # # # # # # # 
#              # 
#  # # # # # # # 
#              # 
#  # # # # # # # 
#              # 
#  # # # # # # # 
#              # 
#  # #E# # # # # 
#              # 
################