####################
#         P        # 
#  # # # # # # # # # 
#  # # # # # # # # # 
#  # # # # # # # # # 
#  # # # # # # # # # 
#  # # # # # # # # # 
#  # # # # # # # # # 
#  # # # # # # # # # 
#  # # # # # # # # # 
#  # # # # # # # # # 
#  # # # # # # # # # 
#                  # 
####################