################
#           P  # 
#  #E# # # # # # 
#              # 
#  # # #E# # # # 
#              # 
# ############ #
#              # 
#  #P# # # #E# # 
#              # 
#  # #E# # # # # 
#              # 
################