###############
#   #     #P  #
# # # # # # # #
#E#   # E #   #
# # # # # # # #
#   #   #   # #
# # # # # # # #
# #   #   #   #
# # # # # # # #
#   #   #   # #
#P# #E# # # # #
#     #       #
###############